25:25
WWWWWWWWWWWWWWWWWWWWWWWWW
W......I................W
W......W................W
W......W................W
W.....FW................W
WWWWWWWW................W
W.......................W
W.......................W
W.......................W
W.......................W
W.......................W
W.......................W
W.......................W
W.......................W
W.......................W
W.......................W
W.......................W
W.......................W
W.......................W
W..................WWWWWW
W..................W....W
W..................I....W
W..................W....X
WP.................Wf...W
WWWWWWWWWWWWWWWWWWWWWWWWW